1111111111111111111111111111111111111111
1000000000000000000000000000000000000001
10000000000000X0000000000000000000000001
1000001100000000000000000000000000110001
1000001110000000000000000000110000001001
1000000000000100000000000000011000000001
100000000000011000000X000000000000000001
1000000000001110000000000000000000000001
1000000000001100000000000000000000000001
1000000000000100000000000X0000000000X001
1000000000000000000000000000000000000001
1001100000000000000000000000000000000001
1011110000000000000000000000000000000001
1000000000000X0000000000X000000001111001
1000000000000000000000000000000001111001
1000000000000000000000000000000001110001
1000000000000000000000000000000000110001
100100000X000000000000000000000000000001
1011100000000000001100000000000000000001
101110000000000000011000000000X000000001
1001000000000000000000000000000000000001
1000000000X00000000000000000000000000001
1000000000000000000000000000000b00000001
111111111111111111111111111111BBBB111111