11111AAAA1111111111111111111111111111111
100000a000000000000000000000011000000001
10X0000000000000100010000000011001000001
1110000000000000000110111111100100000001
1111100000000000111100110111100000100001
1001100000000001111000111111100011111001
1100100000000001111100111111100011011001
1110000000000000001100111111100011011001
1000000000000000000001111111100000000001
1000111000000000000001101000000000000001
1110111110000000000000000000000000000001
111110011000000000000000000000000010000D
11111111100000000000000000000000000000dD
111111011100000000000000000000000000000D
1110010111000000000000000000000000000001
1000000000000000000000000000000000100001
1000010000000000000000000000000001100001
1001000111011110000000000000000001100001
1010100111111110000000000000000000110001
1000010111100000000000000000000000000001
1011000010000000000000000000000000011001
1010010000000000000000000000000000011001
1000000000000000000000c00000000000000001
11111111111111111111CCCC1111111111111111