1111111111BBBB11111111111111111111111111
10000000000b0000000000000000000000000001
1000000000000000000000000000000011000001
1000000000000000000000000000000011000001
1000000000000000000000000011000011000001
1000000000000000000000001111000111100001
1000000000000000000000001100000111100001
1000000000000000000000000011001111110001
1000000000000000000000000011001111110001
1000000000000000000000000000000111100001
1000000000000000000000000000000111100001
1000001000000000000000000000000111101001
1000001000000000000000000000000111111001
1000001011000000000000000000000111111001
1000000011001100000000000000000111111001
1100000000000000000000000000000111110001
1100101001010000000000000000000111111101
1000101001010000000000000000000000000001
1101000000000000000000000000000000000001
1101000000110000000000000000000000000001
1000011000110000000000000000000000000001
1000000000000000000000000000000000000001
1000000000000000000000000000000000000001
1111111111111111111111111111111111111111