1111111111111111111111111111111111111111
1000000000000000000000000000000011000001
1000000000000000000000000011110011000001
B000000001000000000000000011110111100001
B000000001000111111111111000011111110001
Bb00000000000111111111111000101111110001
B000000000000111111111111000001111110101
1000000000000111111111111000001111010101
1000000000001111111111111000001111110001
1000000000001111111111111000000000000001
1000000000000111111111111000000000000001
1000000000000001111111100000000000000001
1111111000000001111111100000000000000001
1111111100000001111111100000000000000001
1111111110000000000000000000000000000001
1111111110100000000000000000000000000001
1111111110100000000000000000000000000001
1111111111100000000000000000000000000001
1111111111100000000000000000000000000001
1111111111000000000000000000000000000001
1000110000000000001000000000000000000001
1000000000000000001000000000000000000001
100000000000000000000000000000000e000001
11111111111111111111111111111111EEEE1111