1111DDDD11111111111111111111111111111111
100000d000000000000000000000000000000001
1000000000000000000000000000000000011111
1000000001111111111000000000000011011111
1000000001111111111000000000000011000001
1000000001111111111000000000000000100001
1000000011111111111000000000000000010001
1010000013331111331000000000000000000001
1010000003333333330000000000000000000001
1001000000000000000000000000000000000001
1001000000000000000000000000000000000001
1001000000000000000000000000000000000001
1000000000000000000000000000000000000001
1000000000000000000000000000000000000001
1000000000000111111111000000000000000001
1000000000000111111111110000000000000001
1001111000000111111111100000000000000001
1001111000000111100000000000111111000001
1111111000000000000000000001111111000001
1111111100000000000000000000111111000001
1441111100000000000000000000101001000001
1444444400000000000000000000000000000001
1000000000000000000000000000000000000001
1111111111111111111111111111111111111111